0x0000022530899CD0, 37692342339351664, 591318683, 591319046, 363, 320x180 
0x0000022530899CD0, 37692342340308192, 591319050, 591319055, 5, 320x180 
0x0000022530899CD0, 37692342343324272, 591319078, 591319145, 67, 320x180 
0x0000022530899CD0, 37692342344317184, 591319177, 591319223, 46, 320x180 
0x0000022530899CD0, 37692342345272104, 591319276, 591319279, 3, 320x180 
0x0000022530899CD0, 37692342346231568, 591319369, 591319373, 4, 320x180 
0x0000022530899CD0, 37692342347354712, 591319486, 591319490, 4, 320x180 
0x0000022530899CD0, 37692342348295488, 591319574, 591319580, 6, 320x180 
0x0000022530899CD0, 37692342349277360, 591319680, 591319684, 4, 320x180 
0x0000022530899CD0, 37692342350227952, 591319769, 591319772, 3, 320x180 
0x0000022530899CD0, 37692342351197904, 591319869, 591319871, 2, 320x180 
0x0000022530899CD0, 37692342352324104, 591319980, 591319983, 3, 320x180 
0x0000022530899CD0, 37692342353259544, 591320071, 591320074, 3, 320x180 
0x0000022530899CD0, 37692342354232592, 591320172, 591320176, 4, 320x180 
0x0000022530899CD0, 37692342355184040, 591320271, 591320273, 2, 320x180 
0x0000022530899CD0, 37692342356127248, 591320360, 591320368, 8, 320x180 
0x0000022530899CD0, 37692342357248208, 591320471, 591320473, 2, 320x180 
0x0000022530899CD0, 37692342358215048, 591320571, 591320575, 4, 320x180 
0x0000022530899CD0, 37692342359190792, 591320664, 591320666, 2, 320x180 
0x0000022530899CD0, 37692342360129288, 591320759, 591320763, 4, 320x180 
0x0000022530899CD0, 37692342361264152, 591320876, 591320882, 6, 320x180 
0x0000022530899CD0, 37692342362212464, 591320969, 591320971, 2, 320x180 
0x0000022530899CD0, 37692342363179008, 591321065, 591321067, 2, 320x180 
0x0000022530899CD0, 37692342364123288, 591321161, 591321163, 2, 320x180 
0x0000022530899CD0, 37692342365102664, 591321256, 591321259, 3, 320x180 
0x0000022530899CD0, 37692342377087976, 591322495, 591322582, 87, 960x540 
0x0000022530899CD0, 37692342377615624, 591322582, 591322586, 4, 960x540 
0x0000022530899CD0, 37692342378568312, 591322615, 591322619, 4, 960x540 
0x0000022530899CD0, 37692342379487128, 591322721, 591322730, 9, 960x540 
0x0000022530899CD0, 37692342380445400, 591322798, 591322802, 4, 960x540 
0x0000022530899CD0, 37692342381405600, 591322902, 591322907, 5, 960x540 
0x0000022530899CD0, 37692342382552856, 591323009, 591323014, 5, 960x540 
0x0000022530899CD0, 37692342383467408, 591323099, 591323103, 4, 960x540 
0x0000022530899CD0, 37692342384428696, 591323196, 591323200, 4, 960x540 
0x0000022530899CD0, 37692342385390224, 591323290, 591323294, 4, 960x540 
0x0000022530899CD0, 37692342386353376, 591323386, 591323391, 5, 960x540 
0x0000022530899CD0, 37692342387467104, 591323500, 591323505, 5, 960x540 
0x0000022530899CD0, 37692342388439688, 591323600, 591323605, 5, 960x540 
0x0000022530899CD0, 37692342389401240, 591323694, 591323699, 5, 960x540 
0x0000022530899CD0, 37692342395349648, 591324713, 591324716, 3, 960x540 
0x0000022530899CD0, 37692342396437936, 591324721, 591324727, 6, 960x540 
0x0000022530899CD0, 37692342400277736, 591324784, 591324787, 3, 960x540 
0x0000022530899CD0, 37692342401416032, 591324904, 591324920, 16, 960x540 
0x0000022530899CD0, 37692342402379336, 591325000, 591325008, 8, 960x540 
0x0000022530899CD0, 37692342403319952, 591325094, 591325103, 9, 960x540 
0x0000022530899CD0, 37692342404265576, 591325192, 591325200, 8, 960x540 
0x0000022530899CD0, 37692342405235472, 591325286, 591325301, 15, 960x540 
0x0000022530899CD0, 37692342406377664, 591325394, 591325403, 9, 960x540 
0x0000022530899CD0, 37692342407328456, 591325488, 591325499, 11, 960x540 
0x0000022530899CD0, 37692342408265448, 591325583, 591325590, 7, 960x540 
0x0000022530899CD0, 37692342409231376, 591325677, 591325684, 7, 960x540 
0x0000022530899CD0, 37692342410366504, 591325793, 591325798, 5, 960x540 
0x0000022530899CD0, 37692342411318176, 591325895, 591325900, 5, 960x540 
0x0000022530899CD0, 37692342412268904, 591325982, 591325991, 9, 960x540 
0x0000022530899CD0, 37692342413230432, 591326081, 591326086, 5, 960x540 
0x0000022530899CD0, 37692342414217936, 591326181, 591326185, 4, 960x540 
0x0000022530899CD0, 37692342415319184, 591326294, 591326300, 6, 960x540 
0x0000022530899CD0, 37692342416286992, 591326397, 591326401, 4, 960x540 
0x0000022530899CD0, 37692342417237040, 591326479, 591326487, 8, 960x540 
0x0000022530899CD0, 37692342418227992, 591326583, 591326589, 6, 960x540 
0x0000022530899CD0, 37692342419165832, 591326679, 591326692, 13, 960x540 
0x0000022530899CD0, 37692342420268240, 591326787, 591326800, 13, 960x540 
0x0000022530899CD0, 37692342421236928, 591326886, 591326898, 12, 960x540 
0x0000022530899CD0, 37692342422210608, 591326976, 591326986, 10, 960x540 
0x0000022530899CD0, 37692342423181720, 591327081, 591327086, 5, 960x540 
0x0000022530899CD0, 37692342424267528, 591327196, 591327201, 5, 960x540 
0x0000022530899CD0, 37692342425231352, 591327284, 591327291, 7, 960x540 
0x0000022530899CD0, 37692342426214376, 591327378, 591327383, 5, 960x540 
0x0000022530899CD0, 37692342427159896, 591327472, 591327478, 6, 960x540 
0x0000022530899CD0, 37692342428105920, 591327567, 591327575, 8, 960x540 
0x0000022530899CD0, 37692342429226272, 591327673, 591327679, 6, 960x540 
0x0000022530899CD0, 37692342430187160, 591327775, 591327780, 5, 960x540 
0x0000022530899CD0, 37692342431154496, 591327871, 591327876, 5, 960x540 
0x0000022530899CD0, 37692342432126224, 591327974, 591327979, 5, 960x540 
0x0000022530899CD0, 37692342433084312, 591328065, 591328069, 4, 960x540 
0x0000022530899CD0, 37692342434196080, 591328177, 591328182, 5, 960x540 
0x0000022530899CD0, 37692342435166592, 591328275, 591328280, 5, 960x540 
0x0000022530899CD0, 37692342436107040, 591328366, 591328369, 3, 960x540 
0x0000022530899CD0, 37692342437082144, 591328465, 591328468, 3, 960x540 
0x0000022530899CD0, 37692342438192976, 591328573, 591328577, 4, 960x540 
0x0000022530899CD0, 37692342439176352, 591328676, 591328680, 4, 960x540 
0x0000022530899CD0, 37692342440127000, 591328772, 591328778, 6, 960x540 
0x0000022530899CD0, 37692342441083288, 591328866, 591328870, 4, 960x540 
0x0000022530899CD0, 37692342442049664, 591328966, 591328970, 4, 960x540 
0x0000022530899CD0, 37692342443179512, 591329069, 591329075, 6, 960x540 
0x0000022530899CD0, 37692343547646864, 591439517, 591439536, 19, 320x180 
0x0000022530899CD0, 37692343548620160, 591439610, 591439615, 5, 320x180 
0x0000022530899CD0, 37692343549564296, 591439705, 591439709, 4, 320x180 
0x0000022530899CD0, 37692343550528152, 591439805, 591439809, 4, 320x180 
0x0000022530899CD0, 37692343551485336, 591439901, 591439905, 4, 320x180 
0x0000022530899CD0, 37692343552596080, 591440011, 591440013, 2, 320x180 
0x0000022530899CD0, 37692343553567816, 591440109, 591440113, 4, 320x180 
0x0000022530899CD0, 37692343554526608, 591440204, 591440207, 3, 320x180 
0x0000022530899CD0, 37692343555490416, 591440305, 591440309, 4, 320x180 
0x0000022530899CD0, 37692343556446304, 591440397, 591440400, 3, 320x180 
0x0000022530899CD0, 37692343557557200, 591440520, 591440523, 3, 320x180 
0x0000022530899CD0, 37692343558515960, 591440599, 591440602, 3, 320x180 
0x0000022530899CD0, 37692343559472656, 591440698, 591440700, 2, 320x180 
0x0000022530899CD0, 37692343560448704, 591440799, 591440802, 3, 320x180 
0x0000022530899CD0, 37692343561558184, 591440908, 591440910, 2, 320x180 
0x0000022530899CD0, 37692343562515488, 591441009, 591441011, 2, 320x180 
0x0000022530899CD0, 37692343563484992, 591441100, 591441106, 6, 320x180 
0x0000022530899CD0, 37692343564447744, 591441196, 591441197, 1, 320x180 
0x0000022530899CD0, 37692343565396104, 591441297, 591441299, 2, 320x180 
0x0000022530899CD0, 37692343566515288, 591441403, 591441414, 11, 320x180 
0x0000022530899CD0, 37692343567478928, 591441502, 591441504, 2, 320x180 
0x0000022530899CD0, 37692343568452976, 591441596, 591441599, 3, 320x180 
0x0000022530899CD0, 37692343569395216, 591441693, 591441695, 2, 320x180 
0x0000022530899CD0, 37692349254884816, 592010244, 592010272, 28, 320x180 
0x0000022530899CD0, 37692349255848568, 592010341, 592010349, 8, 320x180 
0x0000022530899CD0, 37692349256793088, 592010433, 592010436, 3, 320x180 
0x0000022530899CD0, 37692349257903328, 592010544, 592010549, 5, 320x180 
0x0000022530899CD0, 37692349258875688, 592010641, 592010644, 3, 320x180 
0x0000022530899CD0, 37692349259826944, 592010733, 592010737, 4, 320x180 
0x0000022530899CD0, 37692349260797464, 592010834, 592010837, 3, 320x180 
0x0000022530899CD0, 37692349261909304, 592010945, 592010949, 4, 320x180 
0x0000022530899CD0, 37692349262862200, 592011040, 592011042, 2, 320x180 
0x0000022530899CD0, 37692349263822928, 592011134, 592011137, 3, 320x180 
0x0000022530899CD0, 37692349264795008, 592011232, 592011234, 2, 320x180 
0x0000022530899CD0, 37692349265745528, 592011324, 592011331, 7, 320x180 
0x0000022530899CD0, 37692349266884784, 592011441, 592011444, 3, 320x180 
0x0000022530899CD0, 37692349267847200, 592011538, 592011541, 3, 320x180 
0x0000022530899CD0, 37692349268797568, 592011635, 592011637, 2, 320x180 
0x0000022530899CD0, 37692349269745960, 592011727, 592011730, 3, 320x180 
0x0000022530899CD0, 37692349270729536, 592011828, 592011831, 3, 320x180 
0x0000022530899CD0, 37692349271846616, 592011938, 592011941, 3, 320x180 
0x0000022530899CD0, 37692349272807896, 592012033, 592012036, 3, 320x180 
0x0000022530899CD0, 37692349273767264, 592012135, 592012138, 3, 320x180 
0x0000022530899CD0, 37692349274730880, 592012229, 592012232, 3, 320x180 
0x0000022530899CD0, 37692349275686392, 592012324, 592012327, 3, 320x180 
0x0000022530899CD0, 37692349276807304, 592012432, 592012436, 4, 320x180 
0x0000022530899CD0, 37692349277771208, 592012530, 592012537, 7, 320x180 
0x0000022530899CD0, 37692349278725416, 592012624, 592012627, 3, 320x180 
0x0000022530899CD0, 37692349279686768, 592012727, 592012731, 4, 320x180 
0x0000022530899CD0, 37692349280794624, 592012834, 592012837, 3, 320x180 
0x0000022530899CD0, 37692349281745264, 592012929, 592012931, 2, 320x180 
0x0000022530899CD0, 37692349282725160, 592013024, 592013027, 3, 320x180 
0x0000022530899CD0, 37692349283690912, 592013125, 592013128, 3, 320x180 
0x0000022530899CD0, 37692349284648768, 592013217, 592013220, 3, 320x180 
0x0000022530899CD0, 37692349285773296, 592013331, 592013334, 3, 320x180 
0x0000022530899CD0, 37692349286728712, 592013423, 592013427, 4, 320x180 
0x0000022530899CD0, 37692349287687728, 592013527, 592013529, 2, 320x180 
0x0000022530899CD0, 37692349288648424, 592013618, 592013621, 3, 320x180 
0x0000022530899CD0, 37692349289607760, 592013720, 592013722, 2, 320x180 
0x0000022530899CD0, 37692349290728096, 592013827, 592013830, 3, 320x180 
0x0000022530899CD0, 37692349291688088, 592013926, 592013929, 3, 320x180 
0x0000022530899CD0, 37692349292650408, 592014019, 592014022, 3, 320x180 
0x0000022530899CD0, 37692349293591000, 592014112, 592014114, 2, 320x180 
0x0000022530899CD0, 37692349294726488, 592014228, 592014231, 3, 320x180 
0x0000022530899CD0, 37692349295688048, 592014327, 592014329, 2, 320x180 
0x0000022530899CD0, 37692349296650000, 592014421, 592014424, 3, 320x180 
0x0000022530899CD0, 37692349297604232, 592014516, 592014519, 3, 320x180 
0x0000022530899CD0, 37692349298570688, 592014611, 592014614, 3, 320x180 
0x0000022530899CD0, 37692349299688176, 592014724, 592014727, 3, 320x180 
0x0000022530899CD0, 37692349300646912, 592014821, 592014824, 3, 320x180 
0x0000022530899CD0, 37692349301606912, 592014918, 592014920, 2, 320x180 
0x0000022530899CD0, 37692349302570600, 592015014, 592015016, 2, 320x180 
0x0000022530899CD0, 37692349303528952, 592015107, 592015110, 3, 320x180 
0x0000022530899CD0, 37692349304646528, 592015220, 592015223, 3, 320x180 
0x0000022530899CD0, 37692349305605528, 592015315, 592015318, 3, 320x180 
0x0000022530899CD0, 37692349306542400, 592015406, 592015408, 2, 320x180 
0x0000022530899CD0, 37692349307531208, 592015509, 592015512, 3, 320x180 
0x0000022530899CD0, 37692349308644192, 592015622, 592015625, 3, 320x180 
0x0000022530899CD0, 37692349309606792, 592015712, 592015716, 4, 320x180 
0x0000022530899CD0, 37692349310573952, 592015813, 592015816, 3, 320x180 
0x0000022530899CD0, 37692349311530472, 592015907, 592015910, 3, 320x180 
0x0000022530899CD0, 37692349312488080, 592016004, 592016007, 3, 320x180 
0x0000022530899CD0, 37692349313607496, 592016118, 592016121, 3, 320x180 
0x0000022530899CD0, 37692349314569008, 592016210, 592016214, 4, 320x180 
0x0000022530899CD0, 37692349315527808, 592016308, 592016311, 3, 320x180 
0x0000022530899CD0, 37692349316467112, 592016397, 592016399, 2, 320x180 
0x0000022530899CD0, 37692349317428840, 592016497, 592016499, 2, 320x180 
0x0000022530899CD0, 37692349318547384, 592016606, 592016608, 2, 320x180 
0x0000022530899CD0, 37692349319514704, 592016706, 592016708, 2, 320x180 
0x0000022530899CD0, 37692349320466320, 592016800, 592016802, 2, 320x180 
0x0000022530899CD0, 37692349321436640, 592016893, 592016896, 3, 320x180 
0x0000022530899CD0, 37692349322549296, 592017003, 592017006, 3, 320x180 
0x0000022530899CD0, 37692349323505544, 592017101, 592017103, 2, 320x180 
0x0000022530899CD0, 37692349324485736, 592017201, 592017204, 3, 320x180 
0x0000022530899CD0, 37692349325454504, 592017302, 592017305, 3, 320x180 
0x0000022530899CD0, 37692349326394920, 592017395, 592017397, 2, 320x180 
0x0000022530899CD0, 37692349327527800, 592017504, 592017508, 4, 320x180 
0x0000022530899CD0, 37692349328470896, 592017598, 592017600, 2, 320x180 
0x0000022530899CD0, 37692349329447400, 592017696, 592017699, 3, 320x180 
0x0000022530899CD0, 37692349330415280, 592017798, 592017800, 2, 320x180 
0x0000022530899CD0, 37692349331370888, 592017892, 592017894, 2, 320x180 
0x0000022530899CD0, 37692349332465704, 592017999, 592018001, 2, 320x180 
0x0000022530899CD0, 37692349333446248, 592018101, 592018104, 3, 320x180 
0x0000022530899CD0, 37692349334408080, 592018193, 592018197, 4, 320x180 
0x0000022530899CD0, 37692349335375464, 592018290, 592018293, 3, 320x180 
0x0000022530899CD0, 37692349336324080, 592018388, 592018391, 3, 320x180 
0x0000022530899CD0, 37692349337449136, 592018500, 592018503, 3, 320x180 
0x0000022530899CD0, 37692349338393728, 592018588, 592018590, 2, 320x180 
0x0000022530899CD0, 37692349339375888, 592018691, 592018694, 3, 320x180 
0x0000022530899CD0, 37692349340313208, 592018780, 592018783, 3, 320x180 
0x0000022530899CD0, 37692349341446736, 592018902, 592018905, 3, 320x180 
0x0000022530899CD0, 37692349342414896, 592018999, 592019002, 3, 320x180 
0x0000022530899CD0, 37692349343369832, 592019089, 592019092, 3, 320x180 
0x0000022530899CD0, 37692349344327928, 592019187, 592019189, 2, 320x180 
0x0000022530899CD0, 37692349345287176, 592019282, 592019285, 3, 320x180 
0x0000022530899CD0, 37692349346406976, 592019397, 592019400, 3, 320x180 
0x0000022530899CD0, 37692349347370608, 592019491, 592019494, 3, 320x180 
0x0000022530899CD0, 37692349348327272, 592019589, 592019592, 3, 320x180 
0x0000022530899CD0, 37692349349287472, 592019680, 592019684, 4, 320x180 
0x0000022530899CD0, 37692349350248112, 592019775, 592019778, 3, 320x180 
0x0000022530899CD0, 37692349351375344, 592019891, 592019894, 3, 320x180 
0x0000022530899CD0, 37692349352317672, 592019983, 592019986, 3, 320x180 
0x0000022530899CD0, 37692349353269200, 592020081, 592020084, 3, 320x180 
0x0000022530899CD0, 37692349354251600, 592020178, 592020181, 3, 320x180 
0x0000022530899CD0, 37692349355372088, 592020292, 592020294, 2, 320x180 
0x0000022530899CD0, 37692349356327264, 592020384, 592020387, 3, 320x180 
0x0000022530899CD0, 37692349357285864, 592020484, 592020487, 3, 320x180 
0x0000022530899CD0, 37692349358247640, 592020580, 592020583, 3, 320x180 
0x0000022530899CD0, 37692349359209160, 592020674, 592020678, 4, 320x180 
0x0000022530899CD0, 37692349360329656, 592020789, 592020793, 4, 320x180 
0x0000022530899CD0, 37692349361287368, 592020880, 592020883, 3, 320x180 
0x0000022530899CD0, 37692349362247208, 592020980, 592020983, 3, 320x180 
0x0000022530899CD0, 37692349363207896, 592021073, 592021076, 3, 320x180 
0x0000022530899CD0, 37692349364158696, 592021167, 592021169, 2, 320x180 
0x0000022530899CD0, 37692349365289632, 592021286, 592021289, 3, 320x180 
0x0000022530899CD0, 37692349366245208, 592021380, 592021383, 3, 320x180 
0x0000022530899CD0, 37692349367207432, 592021474, 592021480, 6, 320x180 
0x0000022530899CD0, 37692349368171392, 592021571, 592021574, 3, 320x180 
0x0000022530899CD0, 37692349369284064, 592021684, 592021688, 4, 320x180 
0x0000022530899CD0, 37692349370237272, 592021775, 592021778, 3, 320x180 
0x0000022530899CD0, 37692349371199912, 592021874, 592021876, 2, 320x180 
0x0000022530899CD0, 37692349372158952, 592021966, 592021969, 3, 320x180 
0x0000022530899CD0, 37692349373115064, 592022063, 592022065, 2, 320x180 
0x0000022530899CD0, 37692349374224744, 592022175, 592022177, 2, 320x180 
0x0000022530899CD0, 37692349375191184, 592022273, 592022276, 3, 320x180 
0x0000022530899CD0, 37692349376150680, 592022367, 592022370, 3, 320x180 
0x0000022530899CD0, 37692349377110104, 592022461, 592022463, 2, 320x180 
0x0000022530899CD0, 37692349378071712, 592022556, 592022558, 2, 320x180 
0x0000022530899CD0, 37692349379187064, 592022671, 592022674, 3, 320x180 
0x0000022530899CD0, 37692349380167544, 592022769, 592022771, 2, 320x180 
0x0000022530899CD0, 37692349381114552, 592022862, 592022865, 3, 320x180 
0x0000022530899CD0, 37692349382064432, 592022962, 592022964, 2, 320x180 
0x0000022530899CD0, 37692349383189424, 592023072, 592023074, 2, 320x180 
0x0000022530899CD0, 37692349384175168, 592023171, 592023174, 3, 320x180 
0x0000022530899CD0, 37692349385127072, 592023268, 592023271, 3, 320x180 
0x0000022530899CD0, 37692349386092504, 592023362, 592023365, 3, 320x180 
0x0000022530899CD0, 37692349387031480, 592023455, 592023457, 2, 320x180 
0x0000022530899CD0, 37692349388173256, 592023570, 592023573, 3, 320x180 
0x0000022530899CD0, 37692349389128064, 592023665, 592023668, 3, 320x180 
0x0000022530899CD0, 37692349390089520, 592023765, 592023768, 3, 320x180 
0x0000022530899CD0, 37692349391033736, 592023854, 592023856, 2, 320x180 
0x0000022530899CD0, 37692349392008896, 592023952, 592023956, 4, 320x180 
0x0000022530899CD0, 37692349393134040, 592024066, 592024069, 3, 320x180 
0x0000022530899CD0, 37692349394090568, 592024165, 592024168, 3, 320x180 
0x0000022530899CD0, 37692349395043936, 592024262, 592024265, 3, 320x180 
0x0000022530899CD0, 37692349396008848, 592024355, 592024358, 3, 320x180 
0x0000022530899CD0, 37692349397129000, 592024468, 592024471, 3, 320x180 
0x0000022530899CD0, 37692349398086152, 592024564, 592024567, 3, 320x180 
0x0000022530899CD0, 37692349399035864, 592024655, 592024657, 2, 320x180 
0x0000022530899CD0, 37692349399989984, 592024750, 592024752, 2, 320x180 
0x0000022530899CD0, 37692349400970472, 592024850, 592024853, 3, 320x180 
0x0000022530899CD0, 37692349402089968, 592024964, 592024967, 3, 320x180 
0x0000022530899CD0, 37692349403049848, 592025061, 592025064, 3, 320x180 
0x0000022530899CD0, 37692355487082200, 592633464, 592633468, 4, 320x180 
0x0000022530899CD0, 37692355488028144, 592633554, 592633556, 2, 320x180 
0x0000022530899CD0, 37692355489151248, 592633665, 592633668, 3, 320x180 
0x0000022530899CD0, 37692355490122520, 592633768, 592633771, 3, 320x180 
0x0000022530899CD0, 37692355491081664, 592633862, 592633866, 4, 320x180 
0x0000022530899CD0, 37692355492039616, 592633961, 592633964, 3, 320x180 
0x0000022530899CD0, 37692355493001600, 592634054, 592634057, 3, 320x180 
0x0000022530899CD0, 37692355494122280, 592634165, 592634168, 3, 320x180 
0x0000022530899CD0, 37692355495081088, 592634259, 592634263, 4, 320x180 
0x0000022530899CD0, 37692355496041568, 592634359, 592634362, 3, 320x180 
0x0000022530899CD0, 37692355497002944, 592634454, 592634457, 3, 320x180 
0x0000022530899CD0, 37692355497960408, 592634554, 592634557, 3, 320x180 
0x0000022530899CD0, 37692355499085920, 592634664, 592634667, 3, 320x180 
0x0000022530899CD0, 37692355500046992, 592634758, 592634761, 3, 320x180 
0x0000022530899CD0, 37692355500998544, 592634852, 592634854, 2, 320x180 
0x0000022530899CD0, 37692355501964704, 592634952, 592634955, 3, 320x180 
0x0000022530899CD0, 37692355502924192, 592635052, 592635055, 3, 320x180 
0x0000022530899CD0, 37692355504042128, 592635156, 592635160, 4, 320x180 
0x0000022530899CD0, 37692355505004488, 592635254, 592635257, 3, 320x180 
0x0000022530899CD0, 37692355505964672, 592635351, 592635354, 3, 320x180 
0x0000022530899CD0, 37692355506921064, 592635448, 592635450, 2, 320x180 
0x0000022530899CD0, 37692355508042960, 592635557, 592635559, 2, 320x180 
0x0000022530899CD0, 37692355509000328, 592635657, 592635660, 3, 320x180 
0x0000022530899CD0, 37692355509963512, 592635751, 592635754, 3, 320x180 
0x0000022530899CD0, 37692355510940928, 592635843, 592635845, 2, 320x180 
0x0000022530899CD0, 37692355511855848, 592635935, 592635937, 2, 320x180 
0x0000022530899CD0, 37692355512981240, 592636049, 592636051, 2, 320x180 
0x0000022530899CD0, 37692355513947920, 592636145, 592636148, 3, 320x180 
0x0000022530899CD0, 37692355514899208, 592636245, 592636247, 2, 320x180 
0x0000022530899CD0, 37692355515881808, 592636345, 592636347, 2, 320x180 
0x0000022530899CD0, 37692355516842808, 592636438, 592636442, 4, 320x180 
0x0000022530899CD0, 37692355517960680, 592636553, 592636556, 3, 320x180 
0x0000022530899CD0, 37692355519884264, 592636761, 592636788, 27, 424x240 
0x0000022530899CD0, 37692355520828376, 592636835, 592636839, 4, 424x240 
0x0000022530899CD0, 37692355521960016, 592636951, 592636956, 5, 424x240 
0x0000022530899CD0, 37692355522896584, 592637043, 592637044, 1, 424x240 
0x0000022530899CD0, 37692355523884248, 592637143, 592637147, 4, 424x240 
0x0000022530899CD0, 37692355524843632, 592637236, 592637241, 5, 424x240 
0x0000022530899CD0, 37692355525805592, 592637339, 592637343, 4, 424x240 
0x0000022530899CD0, 37692355526919248, 592637445, 592637450, 5, 424x240 
0x0000022530899CD0, 37692355527878816, 592637544, 592637548, 4, 424x240 
0x0000022530899CD0, 37692355528840760, 592637636, 592637640, 4, 424x240 
0x0000022530899CD0, 37692355529802584, 592637734, 592637738, 4, 424x240 
0x0000022530899CD0, 37692355530763416, 592637831, 592637834, 3, 424x240 
0x0000022530899CD0, 37692355531882784, 592637946, 592637950, 4, 424x240 
0x0000022530899CD0, 37692355532842464, 592638037, 592638041, 4, 424x240 
0x0000022530899CD0, 37692355533802136, 592638137, 592638140, 3, 424x240 
0x0000022530899CD0, 37692355534749792, 592638226, 592638228, 2, 424x240 
0x0000022530899CD0, 37692355535858424, 592638334, 592638336, 2, 424x240 
0x0000022530899CD0, 37692355537800984, 592638535, 592638558, 23, 320x180 
0x0000022530899CD0, 37692355538759080, 592638627, 592638632, 5, 320x180 
0x0000022530899CD0, 37692355539722280, 592638730, 592638734, 4, 320x180 
0x0000022530899CD0, 37692355540838960, 592638839, 592638843, 4, 320x180 
0x0000022530899CD0, 37692355541802192, 592638933, 592638937, 4, 320x180 
0x0000022530899CD0, 37692355542762432, 592639033, 592639036, 3, 320x180 
0x0000022530899CD0, 37692355543724464, 592639123, 592639128, 5, 320x180 
0x0000022530899CD0, 37692355544680960, 592639220, 592639223, 3, 320x180 
0x0000022530899CD0, 37692355545814208, 592639338, 592639342, 4, 320x180 
0x0000022530899CD0, 37692355546746688, 592639430, 592639432, 2, 320x180 
0x0000022530899CD0, 37692355557642056, 592640520, 592640524, 4, 320x180 
0x0000022530899CD0, 37692355558581048, 592640610, 592640612, 2, 320x180 
0x0000022530899CD0, 37692355559723320, 592640728, 592640730, 2, 320x180 
0x0000022530899CD0, 37692355560683080, 592640819, 592640822, 3, 320x180 
0x0000022530899CD0, 37692355561662880, 592640919, 592640922, 3, 320x180 
0x0000022530899CD0, 37692355562603928, 592641011, 592641014, 3, 320x180 
0x0000022530899CD0, 37692355563722048, 592641123, 592641126, 3, 320x180 
0x0000022530899CD0, 37692355564683088, 592641220, 592641223, 3, 320x180 
0x0000022530899CD0, 37692355565630528, 592641316, 592641319, 3, 320x180 
0x0000022530899CD0, 37692355566578256, 592641409, 592641411, 2, 320x180 
0x0000022530899CD0, 37692355567537024, 592641503, 592641506, 3, 320x180 
0x0000022530899CD0, 37692355568666656, 592641619, 592641621, 2, 320x180 
0x0000022530899CD0, 37692355569622800, 592641713, 592641715, 2, 320x180 
0x0000022530899CD0, 37692355570579856, 592641810, 592641813, 3, 320x180 
0x0000022530899CD0, 37692355571539072, 592641906, 592641908, 2, 320x180 
0x0000022530899CD0, 37692355572511976, 592642002, 592642005, 3, 320x180 
0x0000022530899CD0, 37692355573641912, 592642118, 592642121, 3, 320x180 
0x0000022530899CD0, 37692355574601480, 592642213, 592642216, 3, 320x180 
0x0000022530899CD0, 37692355575561440, 592642311, 592642314, 3, 320x180 
0x0000022530899CD0, 37692355576542768, 592642412, 592642415, 3, 320x180 
0x0000022530899CD0, 37692355577485720, 592642505, 592642508, 3, 320x180 
0x0000022530899CD0, 37692355578599816, 592642614, 592642617, 3, 320x180 
0x0000022530899CD0, 37692355579562448, 592642707, 592642710, 3, 320x180 
0x0000022530899CD0, 37692355580509560, 592642800, 592642803, 3, 320x180 
0x0000022530899CD0, 37692355581461280, 592642894, 592642897, 3, 320x180 
0x0000022530899CD0, 37692355582597256, 592643012, 592643015, 3, 320x180 
0x0000022530899CD0, 37692355583558336, 592643109, 592643112, 3, 320x180 
0x0000022530899CD0, 37692355584509784, 592643200, 592643202, 2, 320x180 
0x0000022530899CD0, 37692355585471400, 592643301, 592643303, 2, 320x180 
0x0000022530899CD0, 37692355586419400, 592643395, 592643399, 4, 320x180 
0x0000022530899CD0, 37692355587562552, 592643513, 592643516, 3, 320x180 
0x0000022530899CD0, 37692355588521656, 592643608, 592643611, 3, 320x180 
0x0000022530899CD0, 37692355589486256, 592643703, 592643706, 3, 320x180 
0x0000022530899CD0, 37692355590441032, 592643798, 592643801, 3, 320x180 
0x0000022530899CD0, 37692355591402056, 592643897, 592643900, 3, 320x180 
0x0000022530899CD0, 37692355592507296, 592644007, 592644009, 2, 320x180 
0x0000022530899CD0, 37692355593483128, 592644102, 592644105, 3, 320x180 
0x0000022530899CD0, 37692355594441256, 592644199, 592644202, 3, 320x180 
0x0000022530899CD0, 37692355595401128, 592644294, 592644297, 3, 320x180 
0x0000022530899CD0, 37692355596524024, 592644411, 592644414, 3, 320x180 
0x0000022530899CD0, 37692355597485168, 592644499, 592644502, 3, 320x180 
0x0000022530899CD0, 37692355598439912, 592644597, 592644600, 3, 320x180 
0x0000022530899CD0, 37692355599401688, 592644694, 592644696, 2, 320x180 
0x0000022530899CD0, 37692355600360504, 592644791, 592644795, 4, 320x180 
0x0000022530899CD0, 37692355601468848, 592644896, 592644899, 3, 320x180 
0x0000022530899CD0, 37692355602428264, 592644993, 592644996, 3, 320x180 
0x0000022530899CD0, 37692355603405624, 592645097, 592645125, 28, 424x240 
0x0000022530899CD0, 37692355604348800, 592645186, 592645190, 4, 424x240 
0x0000022530899CD0, 37692355605316296, 592645283, 592645288, 5, 424x240 
0x0000022530899CD0, 37692355606440760, 592645414, 592645418, 4, 424x240 
0x0000022530899CD0, 37692355607401000, 592645493, 592645497, 4, 424x240 
0x0000022530899CD0, 37692355608362544, 592645588, 592645593, 5, 424x240 
0x0000022530899CD0, 37692355609319800, 592645683, 592645687, 4, 424x240 
0x0000022530899CD0, 37692355610440240, 592645799, 592645803, 4, 424x240 
0x0000022530899CD0, 37692355611401512, 592645893, 592645897, 4, 424x240 
0x0000022530899CD0, 37692355612360760, 592645992, 592645995, 3, 424x240 
0x0000022530899CD0, 37692355613318256, 592646086, 592646090, 4, 424x240 
0x0000022530899CD0, 37692355614280240, 592646186, 592646189, 3, 424x240 
0x0000022530899CD0, 37692355615404424, 592646293, 592646298, 5, 424x240 
0x0000022530899CD0, 37692355616346776, 592646386, 592646389, 3, 424x240 
0x0000022530899CD0, 37692355617325192, 592646490, 592646494, 4, 424x240 
0x0000022530899CD0, 37692355618272720, 592646582, 592646586, 4, 424x240 
0x0000022530899CD0, 37692355619228944, 592646677, 592646679, 2, 424x240 
0x0000022530899CD0, 37692355620363440, 592646792, 592646795, 3, 424x240 
0x0000022530899CD0, 37692355621319840, 592646887, 592646890, 3, 424x240 
0x0000022530899CD0, 37692355622281256, 592646982, 592646985, 3, 424x240 
0x0000022530899CD0, 37692355623248888, 592647084, 592647087, 3, 424x240 
0x0000022530899CD0, 37692355624365000, 592647192, 592647195, 3, 424x240 
0x0000022530899CD0, 37692355625299488, 592647282, 592647284, 2, 424x240 
0x0000022530899CD0, 37692355626263112, 592647378, 592647380, 2, 424x240 
0x0000022530899CD0, 37692355627227344, 592647475, 592647478, 3, 424x240 
0x0000022530899CD0, 37692355628182008, 592647573, 592647575, 2, 424x240 
0x0000022530899CD0, 37692355629311056, 592647682, 592647684, 2, 424x240 
0x0000022530899CD0, 37692355630272512, 592647779, 592647781, 2, 424x240 
0x0000022530899CD0, 37692355631225008, 592647876, 592647878, 2, 424x240 
0x0000022530899CD0, 37692355632191352, 592647969, 592647972, 3, 424x240 
0x0000022530899CD0, 37692355805145896, 592665267, 592665275, 8, 320x180 
0x0000022530899CD0, 37692355806282304, 592665381, 592665386, 5, 320x180 
0x0000022530899CD0, 37692355807230000, 592665475, 592665479, 4, 320x180 
0x0000022530899CD0, 37692355808197104, 592665572, 592665576, 4, 320x180 
0x0000022530899CD0, 37692355809139664, 592665667, 592665669, 2, 320x180 
0x0000022530899CD0, 37692355810127640, 592665771, 592665775, 4, 320x180 
0x0000022530899CD0, 37692355811242992, 592665875, 592665879, 4, 320x180 
0x0000022530899CD0, 37692355812204784, 592665979, 592665982, 3, 320x180 
0x0000022530899CD0, 37692355813161168, 592666074, 592666078, 4, 320x180 
0x0000022530899CD0, 37692355814122648, 592666167, 592666170, 3, 320x180 
0x0000022530899CD0, 37692355815087888, 592666263, 592666267, 4, 320x180 
0x0000022530899CD0, 37692355816203560, 592666377, 592666380, 3, 320x180 
0x0000022530899CD0, 37692355817164240, 592666474, 592666478, 4, 320x180 
0x0000022530899CD0, 37692355818123808, 592666568, 592666571, 3, 320x180 
0x0000022530899CD0, 37692355819081592, 592666663, 592666666, 3, 320x180 
0x0000022530899CD0, 37692355820208424, 592666775, 592666777, 2, 320x180 
0x0000022530899CD0, 37692355821150336, 592666864, 592666867, 3, 320x180 
0x0000022530899CD0, 37692355822121320, 592666968, 592666971, 3, 320x180 
0x0000022530899CD0, 37692355823085472, 592667063, 592667066, 3, 320x180 
